............................
............................
............................
............................
............................
............................
............................
............................
............................
............................
............................
............................
............................
............................
............................
.................@@@........
............................
............................
..@.....?@@@?...............
............................
............................
............@.......@.......
############################
############################