............................
............................
............................
............................
............................
............................
............................
............................
............................
............................
............................
............................
............................
............................
............................
.................@@@........
............................
............................
........?@@@?...............
............................
............................
.@........................@.
############################
############################