............................
............................
............................
............................
............................
............................
............................
............................
............................
............................
............................
............................
............................
............................
............................
............................
.b.....bb...................
............................
...bbbbbb...................
............................
............................
............................
############################
############################