............................
............................
............................
............................
............................
............................
............................
............................
............................
............................
............................
............................
............................
............................
............................
.................bb.........
.b............b.............
.b..........................
.b....b.bbb.................
.b....b.b...b...............
.b....bbb...................
............................
############################
############################