............................
............................
............................
............................
............................
............................
............................
............................
............................
............................
............................
............................
............................
............................
..........+.................
.................@@@........
............................
............................
..@.....?@@@?...............
............................
M...........................
............@.......@.......
############################
############################